++++++++++++++++++++
+ +   ++ ++        +
  + +++            +
++   ++  ++++ +++ ++
++   ++ ++    +++  +
+       ++  ++  +  +
+ ++ + +     ++  + +
+ ++ +++ + +  ++   +
+  +     + + S+ +  +
 + + + + + +     + +
++ ++++++++++++++++++